NO ./textures/north.png
SO ./textures/south.png
WE ./textures/west.png
EA ./textures/east.png

F 220,100,5
C 225,30,5

1111111111111111111111111
1000000000110000000000001
1011000001110000000000001 
10010000000000000000000011111111111111111110111111
1001000000000000000000000
1011000000100000000000001 
100000000101001    100001
1001000000100000000000001
10110000011100N0000000001
1000000000110000000000001
1001000000000000000000001
1011000001110000000000001
1000000000110000000000001
1000000000000000000000001
1111111111111111111111111