NO ./textures/air_256.png

SO ./textures/fire_256.png

WE ./textures/water_256.png

     EA ./textures/earth_256.png

F 139,69,118
C 139,69,1

111111111111111111111111
100000N00000111100000001
111011111101000101111101
10001000000101010000000
101110111101010101110101
100000100001000100000001
101111101111011111101111
100000100000010000100001
101111111011011011111101
100000001010101000000001
101111111010101011111101
100000000000000000000001
111111111111111111111111
