NO ./textures/north.png

SO ./textures/south.png

WE ./textures/west.png

EA ./textures/east.png

F 139,69,1
C 100,149,237

111111111111111111111111
100001000000000000000001
100000000001000000000001
100000000010100000000001
100000000001000000000011
100000000000000000000101
100000000000000000000011
1000000000000000S0000001
100001000000000000010011
111111111111111111111111
