NO ./textures/north.png

SO ./textures/south.png

WE ./textures/west.png

EA ./textures/east.png

F 139,69,1
C 100,149,237

111111111111111111111111
100001000000000000010001
100000000001000000111001111  1111111
100000000010100000010000001  1000001
100000000001000000000011111  1111111
100000000000000000000101
1000000000000001110000011
1000000000000001S1000001
100001000000000111010001
111111111111111111111111
