NO ./textures/north.png
SO ./textures/south.png
WE ./textures/west.png
EA ./textures/east.png

F 220,100,0
C 225,30,0

1111111111111111111111111                     111111111111111111111111111
1000000000110000010000000                     100000000000000000010000001
1011000001110000000000001                     101100000000000000010000001
10010E0000000000000000001                     100000000000000000010000001
1001000000100000010000001                     100000000000000000010000001
1011111100100000000000001111111111111111111111100000000000000010000000001
1000000001010000000000000000000000000000000000000000000000000000000000001
1001000000100000000000001111111110011111111111100000000100011000000000001
1011000001111111111100001      110011         100000001100100100000000001
1000000000110000010000001     11000011        101100011100100100000000001
1001000000000000010000001     1000000111111111110000110100000100000000001
1011000001110000010000001     1000000000000000000001111100001000000110111
1000000000110000010000001     1100001111111111110000000100010000001000001
1000000000000000000000001      110010000000000010000000100111110000100001
1111111111111111111101111111111111100000000000011111111110011111111111111
                   10000000000000000000000000000000000000001
                   11111111111111111111111111111111111111111
