NO ./textures/air.png

SO ./textures/fire.png

WE  ./textures/water.png

   EA ./textures/earth.png


   C 100,149,237

F 107,142,35

111111111111111111111111
1000000E0000111100000001
111011111101000101111111
100010000001010100000001
101110111101010101110101
100000100001000100000001
101111101111011111101111
100000100000010000100001
101111111011011011111101
100000001010101000000001
101111111010101011111101
100000000000000000000001
111111111111111111111111
