NO ./textures/air_256.png

SO ./textures/fire_256.png

WE ./textures/water_256.png

EA ./textures/earth_256.png

F 139,69,19
C 100,149,237


	        1111111111111111111111111
        1111111100110000000000001
        1011000001110000000000001
        1001000000000000000000001
1111111110000001110000000000001
100000000011000001110001111111111
11110111101111011100000010001
11110111101111011101010010001
11000000100101011100000010001
100000000000000011000N0010001
10000000000000001101010010001
110000011101010111110111100111
11110111 1110101 101111010001
11111111 1111111 111111111111