NO ./path_to_the_north_texture

SO ./path_to_the_south_texture

WE ./path_to_the_west_texture

EA ./path_to_the_east_texture

F 139,69,1
C 100,149,237

111111111111111111111111
100001000000000000000101
100000000001000000000001
10000000001 1000000000011
100000000001000000000001
100000000000000000000001
100000000000000000000001
100000000000000000000001
1000N1000000000000000011
111111111111111111111111
