
NO	   ./textures/air.png

SO ./textures/water.png

WE ./textures/earth.png

EA ./textures/fire.png

   C 100,149,237

F 107,142,35

        1111111111111111111111111
        1111111100110000000000001
        1011000001110000000000001
        1001000000000000000000001
111111111011000001110000000000001
100000000011000001110111111111111
11110111111111011100000010001
11110111111111011101010010001
11000000110101011100000010001
100000000000000011000N0010001
10000000000000001101010010001
11000001110101011111011110011
11110111 1110101 101111010001
11111111 1111111 111111111111

