NO ./textures/air_256.png

SO ./textures/fire_256.png

WE ./textures/water_256.png

EA	./textures/earth_256.png


F 139,69,1
C 100,149,237

111111111111111111111111
100000000000000000000001
100011111111111111110001
1000100000101000000010S1
100010111111011110010011
10001010000000001001011
100010101111111010010011
100010101000001010010001
100010101011111010010001
100000000000000100000001
111111111111111111111111
