
SO ./textures/fire_256.png

WE ./textures/water_256.png

EA	./textures/earth_256.png

F 139,69,1
C 100,149,237

111111111111111111111111
100000000000000000000001
100011111111111111110001
100010000000000000010001
100010111111111110010001
100010100000000010010001
100010101111111010010001
100010101000001010010001
100010101011111010010001
1000000000000000000000N1
111111111111111111111111

NO	./textures/air_256.png
