NO ./textures/air_256.png

SO ./textures/fire_256.png

WE ./textures/water_256.png

EA	./textures/earth_256.png


F 139,69,1
C 100,149,237

111111111111111111111111
100000000000000000000001
1000111111111111111100011
10001000001010000000100111
1000101111110111100100100111111111111
10001010000000001001011111
1000101011111110100100101
1000101010000010100100011
100S10101011111010010001
100000000000000100000001
111111111111111111111111
