NO ./textures/air_256.png

SO ./textures/fire_256.png

WE ./textures/water_256.png

EA	./textures/earth_256.png


F 139,69,1
C 100,149,237

111111111111111111111111
100000000000000000000001
100011111111111111110001
100010000010100000001001
100010111111011110010001
100010100000000010010E1 
100010101111111010010001
100010101000001010010001
100010101011111010010001
100000000000000100000001
111111111111111111111111
