NO ./textures/air_256.png

SO ./textures/fire_256.png

WE ./textures/water_256.png

EA	./textures/earth_256.png


F 139,69,1
C 100,149,237

111111111111111111111111
100000000000000000000001
1000111111111111111100011
1000100000101000000010S1
1000101111110111100100101111111
10001010000000001001011       1
1000101011111110100100101111111
100010101000001010010001
100010101011111010010001
100000000000000100000001
111111111111111111111111
