11111000
11111000
110010000
11111000
11111110
11111100
11111110
11111110