F                                       200,100,0


WE               ./assets/textures/wall_textures/tile01.png

C 244,-1,230


NO ./assets/textures/wall_textures/tile02.png
SO               ./assets/textures/wall_textures/tile03.png 
        EA       ./assets/textures/wall_textures/tile04.png



1111111111111111111111111
1000000000110000000000001
1011000001110000000000001
1001000000000000000000001
10010N0000000000000000001
1011000000100000000000001
1000000001010000000000001
1001000000100000000000001
1011000001110000000000001
1000000000110000000000001
1001000000000000000000001
1011000001110000000000001
1000000000110000000000001
1000000000000000000000001
1111111111111111111111111

